666666666
600600006
602600006
600000006
600610006
600666666
600000006
600000006
666666666