666666666
666666666
666666666
666666666
600010006
600000006
600000006
602030406
666666666