666666666
666666666
666666666
600000006
606016006
666606006
600606006
620006346
666666666