666666666
600000006
600000006
600000006
600010006
600000006
600000006
600626006
666666666