666666666
600000006
600000006
600000006
606010006
600000006
600000006
620304056
666666666