666666666
600000006
600020006
600000006
600010006
606000606
606000606
606345606
666666666