666666666
600000006
600000006
600000006
600010006
600000006
600000006
666263666
666666666