666666666
600006006
600600036
600666666
600010006
600000606
600020006
600504006
666666666