666666666
606666666
606000666
666030666
600010666
660666666
600666666
626666666
666666666