666666666
666666666
666666666
666600006
600016626
660666666
600600066
660006366
666666666