666666666
600000006
600000006
600000006
600010006
666606666
600006006
620666006
666666666