666666666
600000006
600000006
603040506
600010006
600000006
600000006
600020006
666666666