666666666
666600666
666620666
600010006
606666606
600060006
666360666
666664666
666666666