666666666
600000006
666020666
600000006
606010606
606000606
636666646
666666666
666666666