666666666
600000006
600000006
600000006
600010006
666606666
600000006
626666636
666666666